1111111111111111111111111111111111111
110000000000000000000000000000P000001
111111C0000000000C0000000000E00000001
1000000000000000000000000000000000001
1111111111111111111111100111111111111
1000000000000000000000000000C11111111
1C00000000000000000000000C00000000011
1111111111111111111111111111111111111
