1111111111111111
1000000000P00001
10000111111111C1
11111100E0000011
1111111111111111
