1111111111111111111111111111111111
1P000000C0000000000000000C00000001
11010010100100000101001C0000001011
1010010010101010001001000000010101
100E0000000000000000C0000C00000001
1111111111111111111111111111111111
