11111111111111111111
11C100000000000000P1
11110000000000000011
1E111111111111011111
10011000000110011111
1000000000000C011111
11111111111111111111
