1111111111111111111111111111111111
1000000000000000000000000000000001
1101001010010000010100100000001011
1010010010101010001001000000010101
1000000000000000000000000000000001
1111111111111111111111111111111111
