11111111111
10000C10001
10000010001
1000E000001
100000000P1
11111111111
