11111111111111111
10000C00000000001
1C0000000000000C1
11111110111111101
100C0000100000001
1C00000E1C000P001
11111111111111111
