11111111111111111
10000C00000000001
1P0000000000000C1
11111101011111101
100C0000010000001
1C000000E1C000001
11111111111111111
